111111111111111111111111111111111
100000000000000000000000000000001
1P0000000000000010000000000000001
100000011011110010011100100110001
100000110010010010010010101001001
100001100000110010010010101001001
100011000011000010011100101001001
100110000010010010010010101001001
100111111011110010010010100110001
100111111000000010000000000000001
100000011000000010000000000000001
1000000110000000C0000000C00000001
1000000000000000000000000000000E1
111111111111111111111111111111111
