11111111111111111111111111111111111111111111
10000000000000000000000000000000000000000001
1P000000000000000000001000000000000000000001
10000000000001101111001001110010011000000001
10000000000011001001001001001010100100000001
10000000000110000011001001001010100100000001
10000000001100001100001001110010100100000001
10000000011000001001001001001010100100000001
10000000011111101111001001001010011000000001
10000000011111100000001000000000000000000001
10000000000001100000000000000000000000000001
100000000000011000000000000000C0000000000001
10000000000000000000000000000000000000000001
10000000000000000000000000000000000000000001
10000000000000000000000000000000000000000001
10010010011000111010010111010010111000110001
10010010100101000010100010010010100101001001
100111101111010C0011C00010010010100101001001
10010010100101000010100010010010100101001001
10010010100100111010010010001100111000110001
10000000000000000000000000000000000000000001
100000000000000000000000000000000000000000E1
11111111111111111111111111111111111111111111
